1111111
10E0001
1C00001
1P00001
1N00001
1111111